#############
#       #X  #
# ## # #### #
#           #
#### #### ###
#       # ###
# ##### # ###
# ##### # ###
#   ### # ###
### ### # ###
### ##### ###
### ##### ###
###       ###
#############
12 3
