#############
########### #
########### #
##      ### #
#X#### #### #
#           #
#  ### ###  #
#           #
# #### ###  #
#    # # # ##
#    # #    #
# #### #### #
#           #
#############
11 6
