#############
#############
#############
#           #
# ######### #
# ####X#### #
# #### #### #
# #         #
# ######### #
#           #
####### ### #
###       # #
#############
#############
11 3
