#############
#     X #   #
# #####   # #
# ## ## #   #
#### ## #####
#    ##   ###
#### ####  ##
#       ## ##
# ## ###   ##
# ## #   ####
# ## # # ####
#        ####
#############
#############
10 4
